32 32 32 32 32 32 32 32 32 32 32 32 32 32 32 32 32 32 32 32 32 32 32 32 32 32 32 32 32 32 32 32 32 32 32 32 32 32 32 32 32 32 32 32 32 32 32 32 32 32 32 32 32 32 32 32 32 32 32 32 32 32 32 32 32 32 32 32 32 32 32 32 32 32 32 32 32 32 32 32 32 32 32 32 32 32 32 32 32 32 32 32 32 32 32 32 32 32 32 32 
32 18 18 18 18 18 18 18 18 18 18 18 18 18 18 18 18 18 18 18 18 18 18 18 18 18 18 18 18 18 18 18 18 18 18 18 18 18 18 18 18 18 18 18 18 18 18 18 18 18 18 18 18 18 18 18 18 18 18 18 18 18 18 18 18 18 18 18 18 18 18 18 18 18 18 18 18 18 18 18 18 18 18 18 18 18 18 18 18 18 18 18 18 18 18 18 18 18 18 32 
32 18 18 18 18 18 18 18 18 18 18 18 18 18 18 18 18 18 18 18 18 18 18 18 18 18 18 18 18 18 18 18 18 18 18 18 18 18 18 18 18 18 18 18 18 18 18 18 18 18 18 18 18 18 18 18 18 18 18 18 18 18 18 18 18 18 18 18 18 18 18 18 18 18 18 18 18 18 18 18 18 18 18 18 18 18 18 18 18 18 18 18 18 18 18 18 18 18 18 32 
32 18 18 18 18 18 18 18 18 18 18 18 18 18 18 18 18 18 18 18 18 18 18 18 18 18 18 18 18 18 18 18 18 18 18 18 18 18 18 18 18 18 18 18 18 18 18 18 18 18 18 18 18 18 18 18 18 18 18 18 18 18 18 18 18 18 18 18 18 18 18 18 18 18 18 18 18 18 18 18 18 18 18 18 18 18 18 18 18 18 18 18 18 18 18 18 18 18 18 32 
32 18 18 18 18 18 18 18 18 18 18 18 18 18 18 18 18 18 18 18 18 18 18 18 18 18 18 18 18 18 18 18 18 18 18 18 18 18 18 18 18 18 18 18 18 18 18 18 18 18 18 18 18 18 18 18 18 18 18 18 18 18 18 18 18 18 18 18 18 18 18 18 18 18 18 18 18 18 18 18 18 18 18 18 18 18 18 18 18 18 18 18 18 18 18 18 18 18 18 32 
32 18 18 18 18 18 18 18 18 18 18 18 18 18 18 18 18 18 18 18 18 18 18 18 18 18 18 18 18 18 18 18 18 18 18 18 18 18 18 18 18 18 18 18 18 18 18 18 18 18 18 18 18 18 18 18 18 18 18 18 18 18 18 18 18 18 18 18 18 18 18 18 18 18 18 18 18 18 18 18 18 18 18 18 18 18 18 18 18 18 18 18 18 18 18 18 18 18 18 32 
32 18 18 18 18 18 18 28 26 26 26 26 26 26 26 26 29 18 28 26 26 26 26 26 26 26 26 29 18 18 18 18 28 26 26 26 26 26 26 26 26 26 29 18 18 18 18 18 18 18 18 18 28 26 26 26 26 26 26 26 26 26 29 18 18 18 18 18 18 18 18 18 18 18 18 18 18 18 18 18 18 18 18 18 18 18 18 18 18 18 18 18 18 18 18 18 18 18 18 32 
32 18 18 18 18 18 18 24 16 32 32 32 32 32 32 16 25 26 27 16 1 1 1 1 1 1 1 25 26 26 26 26 27 16 1 1 1 1 1 1 1 1 23 18 18 18 18 19 18 19 18 18 24 16 16 16 16 16 16 16 16 16 25 26 29 18 18 18 18 18 28 26 26 26 26 26 26 26 29 18 18 18 18 18 18 18 18 18 18 18 18 18 18 18 18 18 18 18 18 32 
32 18 18 18 18 18 18 24 16 32 17 17 17 17 32 16 16 16 16 16 1 20 21 21 21 22 1 16 16 16 16 16 16 16 16 1 1 1 1 1 1 1 23 18 18 18 18 19 19 19 18 18 24 16 16 32 32 32 32 32 32 32 32 16 25 26 26 26 26 26 27 16 16 16 16 16 16 16 25 29 18 18 18 18 18 18 18 18 18 18 18 18 18 18 18 18 18 18 18 32 
32 18 18 18 18 18 18 24 16 32 17 17 36 17 32 16 16 16 16 16 1 23 19 19 19 24 1 16 16 16 16 16 16 16 16 1 1 1 1 1 1 1 23 18 18 18 18 19 19 19 18 18 24 16 16 32 17 17 17 17 17 17 1 16 16 16 16 16 16 16 16 1 1 16 16 16 16 16 16 25 29 18 18 18 18 18 18 18 18 18 18 18 18 18 18 18 18 18 18 32 
32 18 18 18 18 18 18 24 16 32 17 17 17 17 32 16 16 16 16 16 1 23 19 19 19 24 1 16 16 16 16 16 16 16 16 1 1 1 1 1 1 1 23 18 18 18 18 19 19 19 19 18 24 16 16 32 17 17 36 17 17 32 1 1 1 1 1 16 16 16 1 1 1 16 16 16 16 16 16 16 25 26 26 26 29 18 18 18 18 18 18 18 18 18 18 18 18 18 18 32 
32 18 18 18 18 18 18 24 16 32 17 17 17 17 32 16 16 16 16 16 1 25 26 26 26 27 1 16 16 16 16 16 16 16 16 1 1 1 1 1 1 1 23 18 18 18 18 18 18 18 19 18 24 16 16 32 17 17 17 17 32 16 16 16 16 1 1 1 16 1 1 16 1 16 16 16 16 16 16 16 16 16 16 16 23 18 18 18 18 18 18 18 18 18 18 18 18 18 18 32 
32 18 18 18 18 18 18 24 16 32 32 32 17 32 32 16 16 16 16 16 1 1 12 10 13 1 1 1 1 1 1 1 1 1 1 1 1 12 10 13 1 1 23 18 18 18 18 18 18 18 18 18 24 16 16 32 32 32 17 32 32 16 16 16 16 1 1 1 1 1 16 16 1 1 1 1 1 1 16 16 16 16 16 16 23 18 18 18 18 18 18 18 18 18 18 18 18 18 18 32 
32 18 18 18 18 18 18 24 16 16 16 1 1 1 16 16 16 16 16 16 16 16 8 3 7 16 16 16 16 16 16 16 16 16 16 16 16 8 3 7 20 21 31 18 18 18 18 18 18 18 18 18 30 22 16 16 16 16 1 1 16 16 16 1 1 1 1 1 1 16 16 16 16 1 1 16 16 1 1 1 16 16 16 16 23 18 18 18 18 18 18 18 18 18 18 18 18 18 18 32 
32 18 18 18 18 18 18 24 16 16 16 1 1 1 16 16 16 16 16 16 16 16 8 3 7 16 16 16 16 16 16 16 16 16 16 16 16 8 3 7 23 18 18 18 18 18 18 18 18 18 18 18 18 30 22 16 16 16 1 1 16 16 16 1 1 1 1 16 16 16 16 16 16 16 16 16 16 16 1 1 16 16 16 16 23 18 18 18 18 18 18 18 18 18 18 18 18 18 18 32 
32 18 18 18 18 18 18 30 22 16 16 1 1 1 16 16 16 16 16 16 16 16 8 3 7 16 16 16 16 16 16 16 16 16 16 16 16 8 3 7 23 18 18 18 18 18 18 18 18 18 18 18 18 18 30 22 16 16 1 1 16 16 16 16 16 16 16 16 16 16 16 16 16 16 16 16 16 1 1 16 16 16 16 16 23 18 18 18 18 18 18 18 18 18 18 18 18 18 18 32 
32 18 18 18 18 18 18 18 24 16 16 1 1 1 16 16 16 16 16 16 16 16 8 3 7 1 1 1 16 16 16 16 16 16 16 16 16 8 3 7 23 18 18 18 18 18 18 18 18 18 18 18 18 18 18 24 16 16 16 1 16 16 16 16 16 16 16 16 16 16 16 16 16 1 1 1 1 1 16 16 16 16 16 16 23 18 18 18 18 18 18 18 18 18 18 18 18 18 18 32 
32 18 18 18 18 18 18 18 24 16 16 1 1 1 16 16 16 16 16 16 16 16 8 3 7 16 16 16 16 16 16 16 16 16 16 12 10 11 3 7 23 18 18 18 18 18 18 18 18 18 18 18 18 18 18 24 16 16 1 1 16 16 16 1 1 1 1 1 16 16 1 1 1 1 16 16 16 1 1 1 1 1 16 16 23 18 18 18 18 18 18 18 18 18 18 18 18 18 18 32 
32 18 18 18 18 18 18 28 27 16 1 1 1 16 16 16 16 16 16 16 16 16 8 3 7 16 16 16 16 16 16 16 16 16 16 8 3 3 3 7 23 18 18 18 18 18 18 18 18 18 18 18 18 18 18 24 16 16 1 1 16 16 16 2 1 16 1 1 1 1 1 1 16 16 16 16 16 1 1 1 1 1 16 16 23 18 18 18 18 18 18 18 18 18 18 18 18 18 18 32 
32 18 18 18 18 18 18 24 16 16 1 1 16 16 16 16 16 16 16 16 16 1 8 3 7 1 16 16 16 16 16 16 16 16 16 8 3 4 5 16 23 18 18 18 18 18 18 18 18 18 18 18 18 18 18 24 16 1 1 16 16 16 16 16 16 16 16 16 1 1 1 16 16 16 16 16 16 16 1 1 1 1 1 1 23 18 18 18 18 18 18 18 18 18 18 18 18 18 18 32 
32 18 18 18 18 18 18 24 16 16 1 1 16 1 12 10 10 10 10 10 10 10 11 3 9 10 10 10 10 13 16 16 16 12 10 11 3 7 1 20 31 18 18 18 18 18 18 18 18 18 18 18 18 18 18 24 16 1 1 16 16 16 16 16 16 16 16 16 1 16 16 16 16 16 16 16 1 1 1 1 1 1 1 1 23 18 18 18 18 18 18 18 18 18 18 18 18 18 18 32 
32 18 18 18 18 18 18 24 16 16 1 16 16 1 8 3 3 3 3 3 3 3 3 3 3 3 3 3 3 7 1 1 1 8 3 3 3 7 1 23 18 18 18 18 18 18 18 18 18 18 18 18 18 18 18 24 16 16 1 16 16 1 1 1 1 1 1 16 16 16 16 16 16 16 16 16 1 1 1 1 1 1 1 1 23 18 18 18 18 18 18 18 18 18 18 18 18 18 18 32 
32 18 18 18 18 18 18 24 16 16 1 16 16 1 14 5 5 5 5 5 5 5 6 3 4 5 5 5 5 15 16 16 16 14 5 6 3 7 1 23 18 18 18 18 18 18 18 18 18 18 18 18 18 18 18 24 16 16 1 16 16 1 1 1 1 1 1 16 16 16 16 16 16 16 16 16 1 1 1 1 1 1 1 1 23 18 18 18 18 18 18 18 18 18 18 18 18 18 18 32 
32 18 18 18 18 18 18 24 16 16 1 16 16 1 16 16 16 16 16 16 16 1 8 3 7 1 16 16 16 16 16 16 16 16 16 8 3 7 1 23 18 18 18 18 18 18 18 18 18 18 18 18 18 18 18 24 16 16 1 16 16 1 16 16 16 16 1 1 1 1 1 16 16 16 16 16 16 16 16 16 1 1 1 1 23 18 18 18 18 18 18 18 18 18 18 18 18 18 18 32 
32 18 18 18 18 18 18 24 16 16 1 16 16 1 16 16 16 16 16 16 16 16 8 3 7 16 16 16 16 16 16 16 16 16 16 8 3 7 1 23 18 18 18 18 18 18 18 18 18 18 18 18 18 18 18 24 16 16 1 16 16 1 16 16 16 16 16 16 16 16 1 1 1 1 16 16 16 16 16 16 16 1 1 1 23 18 18 18 18 18 18 18 18 18 18 18 18 18 18 32 
32 18 18 18 18 18 18 24 16 16 1 16 16 1 1 16 16 16 16 16 16 16 8 3 7 16 16 16 16 16 16 16 16 16 16 8 3 7 1 23 18 18 18 18 18 18 18 18 18 18 18 28 26 26 26 27 16 16 1 16 16 1 16 16 16 16 16 16 16 16 1 1 1 1 1 1 16 16 16 16 16 16 1 1 23 18 18 18 18 18 18 18 18 18 18 18 18 18 18 32 
32 18 18 18 18 18 18 30 22 16 1 16 16 16 1 16 16 16 1 16 16 16 8 3 7 16 16 16 16 16 16 16 16 16 16 8 3 7 1 23 18 18 18 18 18 18 18 18 18 18 18 24 16 16 16 16 16 16 1 16 16 1 1 1 1 16 16 16 16 16 16 16 1 1 16 16 16 16 16 33 16 16 16 16 23 18 18 18 18 18 18 18 18 18 18 18 18 18 18 32 
32 18 18 18 18 18 18 28 27 16 1 16 16 16 1 16 16 16 16 16 1 16 8 3 7 1 1 1 16 16 16 16 16 16 16 8 3 7 1 23 18 18 18 18 18 18 18 18 18 18 18 24 16 16 16 16 16 16 1 16 16 16 16 16 1 16 16 16 16 1 1 1 1 16 16 16 16 1 1 1 1 1 16 16 23 18 18 18 18 18 18 18 18 18 18 18 18 18 18 32 
32 18 18 18 18 18 18 24 16 16 1 16 16 16 1 16 16 16 16 16 16 16 8 3 7 16 16 1 16 16 1 16 16 16 16 8 3 7 1 23 18 18 18 18 18 18 18 18 18 18 18 24 16 16 16 1 1 1 1 1 1 1 16 16 1 16 16 16 1 1 16 16 16 16 1 1 1 1 16 16 16 16 16 20 31 18 18 18 18 18 18 18 18 18 18 18 18 18 18 32 
32 18 18 18 18 18 18 24 16 16 1 1 1 1 1 1 16 16 16 16 16 16 8 3 7 16 16 1 16 16 1 16 16 16 16 14 5 15 1 23 18 18 18 18 18 18 18 18 18 18 18 24 16 16 16 1 1 1 1 1 1 1 1 1 1 16 16 16 1 16 16 16 16 16 1 16 16 16 16 1 16 16 20 31 18 18 18 18 18 18 18 18 18 18 18 18 18 18 18 32 
32 18 18 18 18 18 18 24 16 16 1 1 1 1 1 1 16 16 16 16 16 16 8 3 7 16 16 1 16 16 1 16 16 16 16 16 1 16 20 31 18 18 18 18 18 18 18 18 18 18 18 24 16 16 16 1 1 1 1 1 1 1 16 16 16 16 16 16 1 16 16 16 16 16 1 1 1 1 1 1 16 16 23 18 18 18 18 18 18 18 18 18 18 18 18 18 18 18 18 32 
32 18 18 18 18 18 18 30 22 16 1 1 1 1 1 1 16 16 16 16 16 16 8 3 7 16 16 1 1 1 1 16 16 16 16 16 1 1 23 18 18 18 18 18 18 18 18 18 18 18 18 24 16 16 16 1 1 1 1 1 1 1 16 16 16 16 16 16 1 16 16 16 16 16 16 16 16 16 16 1 16 16 25 26 26 29 18 18 18 18 18 18 18 18 18 18 18 18 18 32 
32 18 18 18 18 18 18 18 24 16 1 1 1 1 1 1 16 16 16 16 16 16 8 3 7 16 16 16 16 16 16 16 16 16 16 1 1 1 23 18 18 18 18 18 18 18 18 18 18 18 18 24 16 16 16 16 16 1 1 1 1 1 16 16 1 1 1 1 1 16 16 16 1 1 1 1 1 1 1 1 16 16 16 16 16 23 18 18 18 18 18 18 18 18 18 18 18 18 18 32 
32 18 18 18 18 18 18 18 24 16 1 1 1 1 1 1 16 16 16 16 16 16 8 3 7 16 16 16 16 16 16 16 16 16 16 1 1 1 23 18 18 18 18 18 18 18 18 18 18 18 18 24 16 16 16 16 16 16 16 1 1 1 16 16 1 1 1 1 16 16 16 16 1 16 16 16 16 16 16 16 16 16 16 16 16 23 18 18 18 18 18 18 18 18 18 18 18 18 18 32 
32 18 18 18 18 18 18 18 24 16 1 1 1 1 1 1 16 16 16 16 16 16 8 3 7 16 16 16 16 16 16 16 16 16 16 1 1 1 23 18 18 18 18 18 18 18 18 18 18 18 18 30 21 21 21 21 22 16 16 16 16 16 16 16 1 1 1 1 16 16 16 1 1 16 16 16 16 16 16 16 16 16 16 16 16 23 18 18 18 18 18 18 18 18 18 18 18 18 18 32 
32 18 18 18 18 18 18 28 27 16 16 16 16 16 16 16 16 16 16 16 16 16 14 5 15 16 16 16 16 16 16 16 16 16 16 1 1 1 25 29 18 18 18 18 18 18 18 18 18 18 18 18 18 18 18 18 30 22 16 16 16 16 16 1 1 1 1 1 16 16 16 1 1 1 1 1 1 1 1 1 1 1 1 16 16 23 18 18 18 18 18 18 18 18 18 18 18 18 18 32 
32 18 18 18 18 18 18 24 16 16 16 16 16 16 16 16 16 16 16 16 16 16 1 1 1 1 1 16 16 16 16 16 16 16 1 1 1 1 1 25 29 18 18 18 18 18 18 18 18 18 18 18 18 18 18 18 18 24 16 16 16 16 1 1 1 1 16 16 16 16 1 1 1 1 1 1 1 1 1 1 1 1 1 16 16 23 18 18 18 18 18 18 18 18 18 18 18 18 18 32 
32 18 18 18 18 18 18 24 16 16 16 16 16 16 16 16 16 16 16 1 1 1 1 1 1 1 1 1 16 16 1 16 16 1 1 1 1 1 1 1 23 18 18 18 18 18 18 18 18 18 18 18 18 18 18 18 18 24 16 16 16 1 1 16 16 16 16 16 16 1 1 1 1 1 1 1 1 1 1 1 1 1 1 16 16 23 18 18 18 18 18 18 18 18 18 18 18 18 18 32 
32 18 18 18 18 18 18 24 16 16 16 16 16 16 16 16 16 16 16 1 1 1 1 1 1 1 1 1 16 16 16 16 1 1 1 1 1 1 1 1 23 18 18 18 18 18 18 18 18 18 18 18 18 18 18 18 18 24 16 16 1 1 1 16 16 16 16 1 1 1 1 1 1 1 1 1 1 1 1 1 61 59 1 16 16 23 18 18 18 18 18 18 18 18 18 18 18 18 18 32 
32 18 18 18 18 18 18 24 16 16 33 16 16 16 16 16 16 16 16 1 1 1 1 1 1 1 1 1 1 16 16 16 1 1 1 1 1 16 1 1 23 18 18 18 18 18 18 18 18 18 18 18 18 18 18 18 18 24 16 16 1 1 1 16 16 16 16 1 1 1 1 1 1 1 1 1 1 1 1 1 56 60 1 16 16 23 18 18 18 18 18 18 18 18 18 18 18 18 18 32 
32 18 18 18 18 18 18 24 16 16 1 16 16 1 1 1 1 1 1 1 1 1 1 1 1 1 1 1 1 1 1 1 1 1 16 1 1 1 1 1 23 18 18 18 18 18 18 18 18 18 18 18 18 18 18 18 18 24 16 16 1 1 1 16 16 16 16 1 16 1 1 1 1 1 1 1 1 1 1 1 1 1 1 16 16 23 18 18 18 18 18 18 18 18 18 18 18 18 18 32 
32 18 18 18 18 18 18 24 16 16 1 1 1 1 16 16 16 16 16 1 1 1 1 1 1 1 1 20 21 21 22 1 1 1 1 1 1 1 1 1 23 18 18 18 18 18 18 18 18 18 18 18 18 18 18 18 18 24 16 16 16 16 1 1 16 16 16 16 1 1 1 1 1 1 1 1 1 1 1 1 1 1 1 16 16 23 18 18 18 18 18 18 18 18 18 18 18 18 18 32 
32 18 18 18 18 18 18 24 16 16 16 16 16 16 16 16 16 16 16 16 1 1 1 1 1 1 20 31 18 18 24 1 1 16 1 1 16 1 1 1 23 18 18 18 18 18 18 18 18 18 18 18 18 18 18 18 18 30 22 16 16 16 1 1 1 1 1 1 1 1 1 16 16 16 16 16 16 16 16 16 16 16 16 16 16 23 18 18 18 18 18 18 18 18 18 18 18 18 18 32 
32 18 18 18 18 18 18 24 16 16 16 16 16 16 16 20 21 21 22 16 1 16 16 16 20 21 31 18 18 18 30 22 1 1 1 1 1 1 20 21 31 18 18 18 18 18 18 18 18 18 18 18 18 18 18 18 18 18 30 22 16 16 16 16 16 16 16 16 16 16 16 16 16 20 21 21 21 21 21 21 21 21 22 16 16 23 18 18 18 18 18 18 18 18 18 18 18 18 18 32 
32 18 18 18 18 18 18 24 16 16 16 16 16 16 20 31 18 18 30 22 1 1 1 20 31 18 18 18 18 18 18 30 21 21 21 21 21 21 31 18 18 18 18 18 18 18 18 18 18 18 18 18 18 18 18 18 18 18 18 30 22 16 16 16 16 16 16 16 16 16 16 16 20 31 18 18 18 18 18 18 18 18 30 22 16 23 18 18 18 18 18 18 18 18 18 18 18 18 18 32 
32 18 18 18 18 18 18 30 21 21 21 21 21 21 31 18 18 18 18 30 21 21 21 31 18 18 19 19 19 19 18 18 18 18 18 18 18 18 18 18 18 18 18 18 18 18 18 18 18 18 18 18 18 18 18 18 18 18 18 18 30 21 21 21 21 21 21 21 21 21 21 21 31 18 18 18 18 18 18 18 18 18 18 30 21 31 18 18 18 18 18 18 18 18 18 18 18 18 18 32 
32 18 18 18 18 18 18 18 18 18 18 18 18 18 18 18 18 18 18 18 18 18 18 18 18 18 18 19 19 19 19 18 18 18 18 18 18 18 18 18 18 18 18 18 18 18 18 18 18 18 18 18 18 18 18 18 18 18 18 18 18 18 18 18 18 18 18 18 18 18 18 18 18 18 18 18 18 18 18 18 18 18 18 18 18 18 18 18 18 18 18 18 18 18 18 18 18 18 18 32 
32 18 18 18 18 18 18 18 18 18 18 18 18 18 18 18 18 18 18 18 18 18 18 18 18 18 18 18 18 18 18 18 18 18 18 18 18 18 18 18 18 18 18 18 18 18 18 18 18 18 18 18 18 18 18 18 18 18 18 18 18 18 18 18 18 18 18 18 18 18 18 18 18 18 18 18 18 18 18 18 18 18 18 18 18 18 18 18 18 18 18 18 18 18 18 18 18 18 18 32 
32 18 18 18 18 18 18 18 18 18 18 18 18 18 18 18 18 18 18 18 18 18 18 18 18 18 18 18 18 18 18 18 18 18 18 18 18 18 18 18 18 18 18 18 18 18 18 18 18 18 18 18 18 18 18 18 18 18 18 18 18 18 18 18 18 18 18 18 18 18 18 18 18 18 18 18 18 18 18 18 18 18 18 18 18 18 18 18 18 18 18 18 18 18 18 18 18 18 18 32 
32 18 18 18 18 18 18 18 18 18 18 18 18 18 18 18 18 18 18 18 18 18 18 18 18 18 18 18 18 18 18 18 18 18 18 18 18 18 18 18 18 18 18 18 18 18 18 18 18 18 18 18 18 18 18 18 18 18 18 18 18 18 18 18 18 18 18 18 18 18 18 18 18 18 18 18 18 18 18 18 18 18 18 18 18 18 18 18 18 18 18 18 18 18 18 18 18 18 18 32 
32 18 18 18 18 18 18 18 18 18 18 18 18 18 18 18 18 18 18 18 18 18 18 18 18 18 18 18 18 18 18 18 18 18 18 18 18 18 18 18 18 18 18 18 18 18 18 18 18 18 18 18 18 18 18 18 18 18 18 18 18 18 18 18 18 18 18 18 18 18 18 18 18 18 18 18 18 18 18 18 18 18 18 18 18 18 18 18 18 18 18 18 18 18 18 18 18 18 18 32 
32 18 18 18 18 18 18 18 18 18 18 18 18 18 18 18 18 18 18 18 18 18 18 18 18 18 18 18 18 18 18 18 18 18 18 18 18 18 18 18 18 18 18 18 18 18 18 18 18 18 18 18 18 18 18 18 18 18 18 18 18 18 18 18 18 18 18 18 18 18 18 18 18 18 18 18 18 18 18 18 18 18 18 18 18 18 18 18 18 18 18 18 18 18 18 18 18 18 18 32 
32 18 18 18 18 18 18 18 18 18 18 18 18 18 18 18 18 18 18 18 18 18 18 18 18 18 18 18 18 18 18 18 18 18 18 18 18 18 18 18 18 18 18 18 18 18 18 18 18 18 18 18 18 18 18 18 18 18 18 18 18 18 18 18 18 18 18 18 18 18 18 18 18 18 18 18 18 18 18 18 18 18 18 18 18 18 18 18 18 18 18 18 18 18 18 18 18 18 18 32 
32 18 18 18 18 18 18 18 18 18 18 18 18 18 18 18 18 18 18 18 18 18 18 18 18 18 18 18 18 18 18 18 18 18 18 18 18 18 18 18 18 18 18 18 18 18 18 18 18 18 18 18 18 18 18 18 18 18 18 18 18 18 18 18 18 18 18 18 18 18 18 18 18 18 18 18 18 18 18 18 18 18 18 18 18 18 18 18 18 18 18 18 18 18 18 18 18 18 18 32 
32 18 18 18 18 18 18 18 18 18 18 18 18 18 18 18 18 18 18 18 18 18 18 18 18 18 18 18 18 18 18 18 18 18 18 18 18 18 18 18 18 18 18 18 18 18 18 18 18 18 18 18 18 18 18 18 18 18 18 18 18 18 18 18 18 18 18 18 18 18 18 18 18 18 18 18 18 18 18 18 18 18 18 18 18 18 18 18 18 18 18 18 18 18 18 18 18 18 18 32 
32 18 18 18 18 18 18 18 18 18 18 18 18 18 18 18 18 18 18 18 18 18 18 18 18 18 18 18 18 18 18 18 18 18 18 18 18 18 18 18 18 18 18 18 18 18 18 18 18 18 18 18 18 18 18 18 18 18 18 18 18 18 18 18 18 18 18 18 18 18 18 18 18 18 18 18 18 18 18 18 18 18 18 18 18 18 18 18 18 18 18 18 18 18 18 18 18 18 18 32 
32 18 18 18 18 18 18 28 26 26 26 26 26 26 26 26 29 18 28 26 26 26 26 26 26 26 26 29 18 18 18 18 28 26 26 26 26 26 26 26 26 26 29 18 18 18 18 18 18 18 18 18 28 26 26 26 26 26 26 26 26 26 29 18 18 18 18 18 18 18 18 18 18 18 18 18 18 18 18 18 18 18 18 18 18 18 18 18 18 18 18 18 18 18 18 18 18 18 18 32 
32 18 18 18 18 18 18 24 16 32 32 32 32 32 32 16 25 26 27 16 1 1 1 1 1 1 1 25 26 26 26 26 27 16 1 1 1 1 1 1 1 1 23 18 18 18 18 19 18 19 18 18 24 16 16 16 16 16 16 16 16 16 25 26 29 18 18 18 18 18 28 26 26 26 26 26 26 26 29 18 18 18 18 18 18 18 18 18 18 18 18 18 18 18 18 18 18 18 18 32 
32 18 18 18 18 18 18 24 16 32 17 17 17 17 32 16 16 16 16 16 1 20 21 21 21 22 1 16 16 16 16 16 16 16 16 1 1 1 1 1 1 1 23 18 18 18 18 19 19 19 18 18 24 16 16 32 32 32 32 32 32 32 32 16 25 26 26 26 26 26 27 16 16 16 16 16 16 16 25 29 18 18 18 18 18 18 18 18 18 18 18 18 18 18 18 18 18 18 18 32 
32 18 18 18 18 18 18 24 16 32 17 17 36 17 32 16 16 16 16 16 1 23 19 19 19 24 1 16 16 16 16 16 16 16 16 1 1 1 1 1 1 1 23 18 18 18 18 19 19 19 18 18 24 16 16 32 17 17 17 17 17 17 1 1 16 16 16 1 16 16 16 1 1 16 16 16 16 16 16 25 29 18 18 18 18 18 18 18 18 18 18 18 18 18 18 18 18 18 18 32 
32 18 18 18 18 18 18 24 16 32 17 17 17 17 32 16 16 16 16 16 1 23 19 19 19 24 1 16 16 16 16 16 16 16 16 1 1 1 1 1 1 1 23 18 18 18 18 19 19 19 19 18 24 16 16 32 17 17 17 17 17 32 1 1 1 1 1 1 1 1 1 1 1 16 16 16 16 16 16 16 25 26 26 26 29 18 18 18 18 18 18 18 18 18 18 18 18 18 18 32 
32 18 18 18 18 18 18 24 16 32 17 17 17 17 32 16 16 16 16 16 1 25 26 26 26 27 1 16 16 16 16 16 16 16 16 1 1 1 1 1 1 1 23 18 18 18 18 18 18 18 19 18 24 16 16 32 17 17 17 17 32 16 16 16 1 1 1 1 1 1 1 16 1 16 16 16 16 16 16 16 16 16 16 16 23 18 18 18 18 18 18 18 18 18 18 18 18 18 18 32 
32 18 18 18 18 18 18 24 16 32 32 32 17 32 32 16 16 16 16 16 1 1 12 10 13 1 1 1 1 1 1 1 1 1 1 1 1 12 10 13 1 1 23 18 18 18 18 18 18 18 18 18 24 16 16 32 32 32 17 32 32 16 16 16 16 1 1 1 1 1 16 16 1 1 1 1 1 1 16 16 16 16 16 16 23 18 18 18 18 18 18 18 18 18 18 18 18 18 18 32 
32 18 18 18 18 18 18 24 16 16 16 1 1 1 16 16 16 16 16 16 16 16 8 3 7 16 16 16 16 16 16 16 16 16 16 16 16 8 3 7 20 21 31 18 18 18 18 18 18 18 18 18 30 22 16 16 16 16 1 1 16 16 16 1 1 1 1 1 1 16 16 16 16 1 1 1 1 1 1 1 16 16 16 16 23 18 18 18 18 18 18 18 18 18 18 18 18 18 18 32 
32 18 18 18 18 18 18 24 16 16 16 1 1 1 16 16 16 16 16 16 16 16 8 3 7 16 16 16 16 16 16 16 16 16 16 16 16 8 3 7 23 18 18 18 18 18 18 18 18 18 18 18 18 30 22 16 16 16 1 1 16 16 16 1 1 1 1 16 16 16 16 16 16 16 16 16 16 1 1 1 16 16 16 16 23 18 18 18 18 18 18 18 18 18 18 18 18 18 18 32 
32 18 18 18 18 18 18 30 22 16 16 1 1 1 16 16 16 16 16 16 16 16 8 3 7 16 16 16 16 16 16 16 16 16 16 16 16 8 3 7 23 18 18 18 18 18 18 18 18 18 18 18 18 18 30 22 16 16 1 1 16 16 16 16 16 16 16 16 16 16 16 16 16 16 16 16 1 1 1 16 16 16 16 16 23 18 18 18 18 18 18 18 18 18 18 18 18 18 18 32 
32 18 18 18 18 18 18 18 24 16 16 1 1 1 16 16 16 16 16 16 16 16 8 3 7 1 1 1 16 16 16 16 16 16 16 16 16 8 3 7 23 18 18 18 18 18 18 18 18 18 18 18 18 18 18 24 16 16 16 1 16 16 16 16 16 16 16 16 16 16 16 16 16 1 1 1 1 1 1 1 16 16 16 16 23 18 18 18 18 18 18 18 18 18 18 18 18 18 18 32 
32 18 18 18 18 18 18 18 24 16 16 1 1 1 16 16 16 16 16 16 16 16 8 3 7 16 16 16 16 16 16 16 16 16 16 12 10 11 3 7 23 18 18 18 18 18 18 18 18 18 18 18 18 18 18 24 16 16 1 1 16 16 16 1 1 1 1 16 16 16 16 1 1 1 16 16 16 1 1 1 1 1 16 16 23 18 18 18 18 18 18 18 18 18 18 18 18 18 18 32 
32 18 18 18 18 18 18 28 27 16 1 1 1 16 16 16 16 16 16 16 16 16 8 3 7 16 16 16 16 16 16 16 16 16 16 8 3 3 3 7 23 18 18 18 18 18 18 18 18 18 18 18 18 18 18 24 16 16 1 1 16 16 16 1 1 16 1 1 1 1 1 1 16 16 16 16 16 1 1 1 1 1 16 16 23 18 18 18 18 18 18 18 18 18 18 18 18 18 18 32 
32 18 18 18 18 18 18 24 16 16 1 1 16 16 16 16 16 16 16 16 16 1 8 3 7 1 16 16 16 16 16 16 16 16 16 8 3 4 5 16 23 18 18 18 18 18 18 18 18 18 18 18 18 18 18 24 16 1 1 1 16 16 16 16 16 16 1 1 1 1 1 1 16 16 16 16 16 16 1 1 1 1 1 1 23 18 18 18 18 18 18 18 18 18 18 18 18 18 18 32 
32 18 18 18 18 18 18 24 16 16 1 1 16 1 12 10 10 10 10 10 10 10 11 3 9 10 10 10 10 13 16 16 16 12 10 11 3 7 1 20 31 18 18 18 18 18 18 18 18 18 18 18 18 18 18 24 16 1 1 1 16 16 16 16 16 16 16 1 1 16 16 1 1 16 16 16 1 1 1 1 1 1 1 1 23 18 18 18 18 18 18 18 18 18 18 18 18 18 18 32 
32 18 18 18 18 18 18 24 16 16 1 16 16 1 8 3 3 3 3 3 3 3 3 3 3 3 3 3 3 7 1 1 1 8 3 3 3 7 1 23 18 18 18 18 18 18 18 18 18 18 18 18 18 18 18 24 16 1 1 1 16 1 1 1 1 1 1 16 1 1 16 16 1 16 16 16 1 1 1 1 1 1 1 1 23 18 18 18 18 18 18 18 18 18 18 18 18 18 18 32 
32 18 18 18 18 18 18 24 16 16 1 16 16 1 14 5 5 5 5 5 5 5 6 3 4 5 5 5 5 15 16 16 16 14 5 6 3 7 1 23 18 18 18 18 18 18 18 18 18 18 18 18 18 18 18 24 16 1 1 1 16 1 1 1 1 1 1 16 16 16 16 16 16 16 16 16 1 1 1 1 1 1 1 1 23 18 18 18 18 18 18 18 18 18 18 18 18 18 18 32 
32 18 18 18 18 18 18 24 16 16 1 16 16 1 16 16 16 16 16 16 16 1 8 3 7 1 16 16 16 16 16 16 16 16 16 8 3 7 1 23 18 18 18 18 18 18 18 18 18 18 18 18 18 18 18 24 16 16 1 1 16 1 1 1 16 1 1 1 1 1 1 16 16 16 16 16 1 1 1 1 1 1 1 1 23 18 18 18 18 18 18 18 18 18 18 18 18 18 18 32 
32 18 18 18 18 18 18 24 16 16 1 16 16 1 16 16 16 16 16 16 16 16 8 3 7 16 16 16 16 16 16 16 16 16 16 8 3 7 1 23 18 18 18 18 18 18 18 18 18 18 18 18 18 18 18 24 16 16 1 1 16 1 1 16 16 16 1 1 1 1 1 1 1 1 16 16 16 1 16 16 1 1 1 1 23 18 18 18 18 18 18 18 18 18 18 18 18 18 18 32 
32 18 18 18 18 18 18 24 16 16 1 16 16 1 1 16 16 16 16 16 16 16 8 3 7 16 16 16 16 16 16 16 16 16 16 8 3 7 1 23 18 18 18 18 18 18 18 18 18 18 18 28 26 26 26 27 16 16 1 1 1 1 1 1 16 16 16 16 1 1 1 1 1 1 1 1 16 16 16 16 16 1 1 1 38 39 18 18 18 18 18 18 18 18 18 18 18 18 18 32 
32 18 18 18 18 18 18 30 22 16 1 16 16 16 1 16 16 16 1 16 16 16 8 3 7 16 16 16 16 16 16 16 16 16 16 8 3 7 1 23 18 18 18 18 18 18 18 18 18 18 18 24 16 16 16 16 16 16 1 1 1 1 1 1 1 16 16 16 16 1 1 1 1 1 16 16 16 16 1 1 16 16 16 1 23 18 18 18 18 18 18 18 18 18 18 18 18 18 18 32 
32 18 18 18 18 18 18 28 27 16 1 16 16 16 1 16 16 16 16 16 1 16 8 3 7 1 1 1 16 16 16 16 16 16 16 8 3 7 1 23 18 18 18 18 18 18 18 18 18 18 18 24 16 16 16 16 16 16 1 1 1 1 1 1 1 16 16 16 16 1 1 1 1 16 16 16 16 1 1 1 1 33 16 16 23 18 18 18 18 18 18 18 18 18 18 18 18 18 18 32 
32 18 18 18 18 18 18 24 16 16 1 16 16 16 1 16 16 16 16 16 16 16 8 3 7 16 16 1 16 16 1 16 16 16 16 8 3 7 1 38 39 18 18 18 18 18 18 18 18 18 18 24 16 16 16 1 1 1 1 1 1 1 1 1 1 16 16 16 1 1 1 1 16 16 1 1 1 1 16 16 16 16 16 20 31 18 18 18 18 18 18 18 18 18 18 18 18 18 18 32 
32 18 18 18 18 18 18 24 16 16 1 1 1 1 1 1 16 16 16 16 16 16 8 3 7 16 16 1 16 16 1 16 16 16 16 14 5 15 1 23 18 18 18 18 18 18 18 18 18 18 18 24 16 16 16 1 1 1 1 1 1 1 1 1 1 16 1 16 1 1 1 16 16 16 1 16 16 16 16 1 16 16 20 31 18 18 18 18 18 18 18 18 18 18 18 18 18 18 18 32 
32 18 18 18 18 18 18 24 16 16 1 1 1 1 1 1 16 16 16 16 16 16 8 3 7 16 16 1 16 16 1 16 16 16 16 16 1 16 20 31 18 18 18 18 18 18 18 18 18 18 18 24 16 16 16 1 1 1 1 1 1 1 16 16 16 16 1 16 1 1 16 16 16 16 1 1 1 1 1 1 16 16 23 18 18 18 18 18 18 18 18 18 18 18 18 18 18 18 18 32 
32 18 18 18 18 18 18 30 22 16 1 1 1 1 1 1 16 16 16 16 16 16 8 3 7 16 16 1 1 1 1 16 16 16 16 16 1 1 23 18 18 18 18 18 18 18 18 18 18 18 18 24 16 16 16 1 1 1 1 1 1 1 16 16 16 1 1 1 1 1 16 16 16 16 16 16 16 16 16 1 16 16 25 26 26 29 18 18 18 18 18 18 18 18 18 18 18 18 18 32 
32 18 18 18 18 18 18 18 24 16 1 1 1 1 1 1 16 16 16 16 16 16 8 3 7 16 16 16 16 16 16 16 16 16 16 1 1 1 23 18 18 18 18 18 18 18 18 18 18 18 18 24 16 16 16 16 16 1 1 1 1 1 16 16 1 1 1 1 1 16 16 16 1 1 1 1 1 1 1 1 16 16 16 16 16 23 18 18 18 18 18 18 18 18 18 18 18 18 18 32 
32 18 18 18 18 18 18 18 24 16 1 1 1 1 1 1 16 16 16 16 16 16 8 3 7 16 16 16 16 16 16 16 16 16 16 1 1 1 23 18 18 18 18 18 18 18 18 18 18 18 18 24 16 16 16 16 16 16 16 1 1 1 16 16 1 1 1 1 16 16 16 16 1 16 16 16 16 16 16 16 16 16 16 16 16 23 18 18 18 18 18 18 18 18 18 18 18 18 18 32 
32 18 18 18 18 18 18 18 24 16 1 1 1 1 1 1 16 16 16 16 16 16 8 3 7 16 16 16 16 16 16 16 16 16 16 1 1 1 23 18 18 18 18 18 18 18 18 18 18 18 18 30 21 21 21 21 22 16 16 16 16 16 16 16 1 1 1 1 16 16 16 1 1 16 16 16 16 16 16 16 16 16 16 16 16 23 18 18 18 18 18 18 18 18 18 18 18 18 18 32 
32 18 18 18 18 18 18 28 27 16 16 16 16 16 16 16 16 16 16 16 16 16 14 5 15 16 16 16 16 16 16 16 16 16 16 1 1 1 25 29 18 18 18 18 18 18 18 18 18 18 18 18 18 18 18 18 30 22 16 16 16 16 16 1 1 1 1 1 16 16 16 1 1 1 1 1 1 1 1 1 1 1 1 16 16 23 18 18 18 18 18 18 18 18 18 18 18 18 18 32 
32 18 18 18 18 18 18 24 16 16 16 16 16 16 16 16 16 16 16 16 16 16 1 1 1 1 1 16 16 16 16 16 16 16 1 1 1 1 1 25 29 18 18 18 18 18 18 18 18 18 18 18 18 18 18 18 18 24 16 16 16 16 1 1 1 1 16 16 16 16 1 1 1 1 1 1 1 1 1 1 1 1 1 16 16 23 18 18 18 18 18 18 18 18 18 18 18 18 18 32 
32 18 18 18 18 18 18 24 16 16 16 16 16 16 16 16 16 16 16 1 1 1 1 1 1 1 1 1 16 16 1 16 16 1 1 1 1 1 1 1 23 18 18 18 18 18 18 18 18 18 18 18 18 18 18 18 18 24 16 16 16 1 1 16 16 16 16 16 16 1 1 1 1 1 1 1 1 1 1 1 1 1 1 16 16 23 18 18 18 18 18 18 18 18 18 18 18 18 18 32 
32 18 18 18 18 18 18 24 16 16 16 16 16 16 16 16 16 16 16 1 1 1 1 1 1 1 1 1 16 16 16 16 1 1 1 1 1 1 1 1 23 18 18 18 18 18 18 18 18 18 18 18 18 18 18 18 18 24 16 16 1 1 1 16 16 16 16 1 1 1 1 1 1 1 1 1 1 1 1 1 61 59 1 16 16 23 18 18 18 18 18 18 18 18 18 18 18 18 18 32 
32 18 18 18 18 18 18 24 16 16 33 16 16 16 16 16 16 16 16 1 1 1 1 1 1 1 1 1 1 16 16 16 1 1 1 1 1 16 1 1 23 18 18 18 18 18 18 18 18 18 18 18 18 18 18 18 18 24 16 16 1 1 1 16 16 16 16 1 1 1 1 1 1 1 1 1 1 1 1 1 56 60 1 16 16 23 18 18 18 18 18 18 18 18 18 18 18 18 18 32 
32 18 18 18 18 18 18 24 16 16 1 16 16 1 1 1 1 1 1 1 1 1 1 1 1 1 1 1 1 1 1 1 1 1 16 1 1 1 1 1 23 18 18 18 18 18 18 18 18 18 18 18 18 18 18 18 18 24 16 16 1 1 1 1 16 16 16 1 1 1 1 1 1 1 1 1 1 1 1 1 1 1 1 16 16 23 18 18 18 18 18 18 18 18 18 18 18 18 18 32 
32 18 18 18 18 18 18 24 16 16 1 1 1 1 16 16 16 16 16 1 1 1 1 1 1 1 1 20 21 21 22 1 1 1 1 1 1 1 1 1 23 18 18 18 18 18 18 18 18 18 18 18 18 18 18 18 18 24 16 16 16 16 1 1 1 16 16 16 1 1 1 1 1 1 1 1 1 1 1 1 1 1 1 16 16 23 18 18 18 18 18 18 18 18 18 18 18 18 18 32 
32 18 18 18 18 18 18 24 16 16 16 16 16 16 16 16 16 16 16 16 1 1 1 1 1 1 20 31 18 18 24 1 1 16 1 1 16 1 1 1 23 18 18 18 18 18 18 18 18 18 18 18 18 18 18 18 18 30 22 16 16 16 1 1 1 1 1 1 1 1 1 16 16 16 16 16 16 16 16 16 16 16 1 16 16 23 18 18 18 18 18 18 18 18 18 18 18 18 18 32 
32 18 18 18 18 18 18 24 16 16 16 16 16 16 16 20 21 21 22 16 1 16 16 16 20 21 31 18 18 18 30 22 1 1 1 1 1 1 20 21 31 18 18 18 18 18 18 18 18 18 18 18 18 18 18 18 18 18 30 22 16 16 16 16 16 16 16 16 16 16 16 16 16 20 21 21 21 21 21 21 21 21 22 16 16 23 18 18 18 18 18 18 18 18 18 18 18 18 18 32 
32 18 18 18 18 18 18 24 16 16 16 16 16 16 20 31 18 18 30 22 1 1 1 20 31 18 18 18 18 18 18 30 21 21 21 21 21 21 31 18 18 18 18 18 18 18 18 18 18 18 18 18 18 18 18 18 18 18 18 30 22 16 16 16 16 16 16 16 16 16 16 16 20 31 18 18 18 18 18 18 18 18 30 22 16 23 18 18 18 18 18 18 18 18 18 18 18 18 18 32 
32 18 18 18 18 18 18 30 21 21 21 21 21 21 31 18 18 18 18 30 21 21 21 31 18 18 19 19 19 19 18 18 18 18 18 18 18 18 18 18 18 18 18 18 18 18 18 18 18 18 18 18 18 18 18 18 18 18 18 18 30 21 21 21 21 21 21 21 21 21 21 21 31 18 18 18 18 18 18 18 18 18 18 30 21 31 18 18 18 18 18 18 18 18 18 18 18 18 18 32 
32 18 18 18 18 18 18 18 18 18 18 18 18 18 18 18 18 18 18 18 18 18 18 18 18 18 18 19 19 19 19 18 18 18 18 18 18 18 18 18 18 18 18 18 18 18 18 18 18 18 18 18 18 18 18 18 18 18 18 18 18 18 18 18 18 18 18 18 18 18 18 18 18 18 18 18 18 18 18 18 18 18 18 18 18 18 18 18 18 18 18 18 18 18 18 18 18 18 18 32 
32 18 18 18 18 18 18 18 18 18 18 18 18 18 18 18 18 18 18 18 18 18 18 18 18 18 18 18 18 18 18 18 18 18 18 18 18 18 18 18 18 18 18 18 18 18 18 18 18 18 18 18 18 18 18 18 18 18 18 18 18 18 18 18 18 18 18 18 18 18 18 18 18 18 18 18 18 18 18 18 18 18 18 18 18 18 18 18 18 18 18 18 18 18 18 18 18 18 18 32 
32 18 18 18 18 18 18 18 18 18 18 18 18 18 18 18 18 18 18 18 18 18 18 18 18 18 18 18 18 18 18 18 18 18 18 18 18 18 18 18 18 18 18 18 18 18 18 18 18 18 18 18 18 18 18 18 18 18 18 18 18 18 18 18 18 18 18 18 18 18 18 18 18 18 18 18 18 18 18 18 18 18 18 18 18 18 18 18 18 18 18 18 18 18 18 18 18 18 18 32 
32 32 32 32 32 32 32 32 32 32 32 32 32 32 32 32 32 32 32 32 32 32 32 32 32 32 32 32 32 32 32 32 32 32 32 32 32 32 32 32 32 32 32 32 32 32 32 32 32 32 32 32 32 32 32 32 32 32 32 32 32 32 32 32 32 32 32 32 32 32 32 32 32 32 32 32 32 32 32 32 32 32 32 32 32 32 32 32 32 32 32 32 32 32 32 32 32 32 32 32 
